0
1 3 4 6 7 8 9 12 13 14 15 17 18 19 20 21 22 23 24 26 28 29 30 31 33 34 35 36 37 38 39
2 5 10 25 32 40
11 16 27
41 52 58
42 44 45 46 47 49 50 51 53 54 55 56 57 59 60 61 62 63 64 65 66 67 68 69 70 71 72 73 74 75 76
43 48
77 87 93
78 80 81 82 83 84 85 86 88 89 91 92 94 95 96 97 98 99 101 102 103 104 105 106 107 108 109 110 111
79
90
100
112 115 123 129 138 141 145 151 153
113 114 116 118 119 120 121 122 124 125 126 127 128 130 131 132 133 134 135 136 137 139 140 142 143 144 146 147 148 149 150 152 154 155
117
156 167 174
157 158 159 161 162 164 165 166 168 169 170 171 173 175 176 177 178 180 181 182 183 184 185 186 187 188 189 190 191 192 193
160
163 172 179
194 195 196 197 198 199 201 202 203 205 206 207 208 209 210 211 212 213 214 216 217 218 220 221 222 223 224 225 226 227 228 230 231
200
204 215 219
229
232 241 248
233 234 235 236 237 238 239 240 242 243 244 246 247 250 251 253 254 255 256 257 259 261 262 263 264 265 267 268 269 270
245 252 258 260 266
249
271 272 273 274 275 276 277 278 280 281 282 283 284 285 286 287 288 289 290 291 292 293 294 295 296 297 298 299 300 301 302 303 304 305
279
306 307 308 309 310 311 312 313 314 316 317 318 319 320 321 322 323 324 326 327 328 329 330 331 332 333 334 335 336 338 339 340 341
315
325
337
342 343 345 346 347 348 350 351 352 353 356 357 358 359 361 362 363 365 366 367 368 369 371 373 374 375 376 377 379 380 381 382 383 384
344 349 355 360 364 370 372 378
354
385 400 406
386 388 389 391 393 395 396 397 398 399 402 404 405 407 408 410 411 412 413 416 417 418 420 421 422 423 424 425 426
387 390 392 394 403 409 419
401
414
415
427
428 429 430 431 432 433 434 435 436 437 438 440 441 442 443 445 447 448 449 450 451 452 453 456 458 459 460 461 462 463 465 466 467 468
439 444 446 454 464
455
457
469 470 471 472 473 474 475 476 477 478 479 480 482 483 485 486 487 488 489 491 492 493 494 495 496 497 499 500 501 502 503 504
481
484
490
498
505 516 521
506 507 508 509 510 511 512 513 514 515 517 518 519 522 523 524 525 526 527 528 529 530 531 532 533 534 535 536 537 538 539
520
540 541 542 543 544 545 546 547 548 549 550 551 552 553 554 555 557 558 559 560 561 562 563 564 565 566 567 568 569 571 572 573 574
556
570
575 576 577 578 579 580 581 582 583 584 585 586 587 588 589 590 591 592 593 595 596 597 598 599 600 601 602 603 604 605 606 607 608 609
594
610 611 612 613 614 615 616 617 618 619 620 621 622 623 624 625 626 627 628 629 630 631 632 633 634 635 636 638 639 640 641 642 643
637
644 655 661
645 646 647 648 649 650 651 652 653 654 656 657 658 659 660 662 663 664 665 666 667 669 670 671 672 673 674 675 677 678
668
676
679 680 681 682 683 684 685 687 688 689 690 691 692 693 694 695 696 697 699 700 701 702 703 704 705 706 707 708 709 711 712 714 715
686 710 713
698
716 717 718 719 720 721 722 723 724 725 727 728 729 732 733 734 735 736 738 739 740 741 742 743 744 745 746 747 748 749 750 751
726
730
731 737
752 763 770
753 754 755 756 757 758 759 760 761 762 765 766 767 768 771 772 774 775 776 777 780 781 783 785 788 789 791 792
764
769 773 784 790
778
779
782
786
787
793 802 810 817 823 829 833
794 795 796 797 798 799 800 801 803 804 805 806 807 808 809 811 812 813 815 816 819 821 822 824 825 826 827 828 830 831 832 834 835
814
818
820
836 839 840 841 843 844 845 847 848 849 850 851 852 853 854 856 857 859 860 861 864 865 866 868 869 870 871
837 838 842 855 862 873
846 872
858
863
867
874
875 886 892
876 877 878 879 880 881 882 883 884 885 887 888 889 890 891 893 895 896 897 898 899 900 901 903 904 905 906 907 908 909
894
902
910 911 912 913 914 915 916 917 918 919 920 921 922 923 924 925 926 927 928 930 931 932 933 934 935 936 937 939 941 942 943 944 945
929 938
940
946
947
948 959 965
949 950 951 952 953 954 955 956 957 958 960 961 962 963 964 966 967 968 969 970 971 972 973 974 975 976 977 979 980 981 982
978
983 984 985 986 987 988 989 990 991 992 993 995 996 997 998 999 1000 1001 1002 1003 1004 1005 1006 1007 1008 1010 1011 1012 1013 1014 1015 1016 1017
994
1009
1018 1019 1020 1021 1022 1023 1024 1025 1026 1027 1028 1029 1030 1031 1032 1033 1034 1035 1036 1037 1038 1039 1040 1041 1042 1043 1044 1045 1046 1047 1048 1049 1051 1052
1050
1053 1054 1055 1056 1057 1058 1059 1060 1061 1062 1063 1064 1065 1066 1067 1068 1069 1070 1071 1072 1073 1074 1075 1076 1077 1078 1079 1080 1081 1082 1083 1084 1085 1087
1086
1088 1089 1090 1091 1092 1093 1094 1095 1097 1098 1099 1100 1101 1102 1103 1104 1105 1106 1107 1108 1109 1110 1111 1112 1113 1115 1116 1117 1118 1119 1120 1122 1123
1096
1114
1121
1124
