0 1 2 3 4 6 7 8 9 10 11 12 14 15 16 17 18 19 20 21 24 25 26 27 28 29 30 32 33 34 35 36
5
13
22
23
31
37
38 50 56
39 43
40 44
41 42 45 47 48 49 51 52 53 54 55 57 58 59 60 61 62 63 64 65 66 67 68 69 70 71 72 73 75
46
74
76 87 93
77 78 79 80 81 82 85 86 88 89 90 91 92 94 95 96 97 98 99 100 101 102 103 104 105 106 107 108 109 110 111
83
84
112 113 114 115 116 117 118 119 120 121 122 123 124 125 126 127 128 129 130 131 132 133 135 136 137 138 139 140 141 142 143 144 145
134
146 156 165
147 148 149 151 153 154 157 159 160 161 163 167 168 169 170 171 173 174 175 177 178 179 180 182 183 184 185 186 187
150 152
155
158 162 164 172 176 181
166
188 211
189 190 192 193 195 197 199 202 205 207 208 209 210 212 213 215 216 217 218 220 221 222 223 224 225 226 227 228 229 230 232
191 194 196 198 201 206 214 219 231
200
203
204
233 251 256 263
234 235 236 237 238 239 240 241 242 244 245 246 247 248 249 250 252 253 254 255 257 258 259 260 262 264 265 266 267 268 269 270 271
243
261
272 283 291
273 275 276 277 278 279 280 281 282 285 287 288 290 292 293 294 296 297 298 300 301 302 303 304 305 306 307 308 309 310 311
274 286 289 295 299
284
312 313 314 315 316 317 318 320 321 322 323 325 326 328 329 330 331 333 334 335 337 338 340 342 343 344 345 347 348 349 350 351 352 353
319 324 327 332 336 339 341 346
354 355 356 358 359 360 361 362 363 365 366 368 369 370 373 375 376 377 379 381 382 383 384 385 386 387 388 390 391 394 395 397
357 364 371 378 380 389 393 396
367 392
372
374
398 412 414 418 422 429 432 436
399
400 402 403 404 405 406 407 408 409 410 411 413 415 416 417 419 420 421 423 424 425 426 427 428 430 431 433 434 435 437 438 439 440 441
401
442 443 444 445 446 447 448 449 450 451 452 453 454 455 456 457 458 459 462 463 464 465 466 467 468 469 470 471 472 473 474 475 476
460
461
477 489 494
478 479 480 481 485 486 487 488 490 491 492 493 496 497 498 499 500 501 502 503 504 505 506 507 508 509 511 512
482
483 510
484
495
513 524 528 530 538 541 544 546 550
514 515 516 517 518 519 520 521 522 523 525 526 527 529 531 532 533 534 537 539 540 542 543 545 547 548 549 551 552 553 554 555 556 557
535
536
558 559 560 561 562 563 564 565 567 568 569 570 571 572 573 574 575 576 577 579 580 581 582 583 584 585 586 587 588 589 590 591 595
566 594
578
592
593
596 607 612
597 598 599 600 601 602 603 604 605 606 608 609 610 611 613 614 615 616 617 618 619 620 621 622 623 624 625 626 627 628 629
630 631 633 634 636 637 638 639 640 642 643 644 645 646 647 648 649 650 651 652 653 655 656 657 658 659 660 661 662 663 664 666 667 668
632 635 641 665 669
654
670 672 673 675 676 677 678 679 680 682 683 684 686 687 688 689 690 692 693 694 696 697 698 699 700 701 703 706 707 708
671 681 691
674
685 702 705
695
704
709 710 711 712 714 715 716 718 719 720 721 722 723 724 725 726 727 728 729 730 731 732 734 735 736 737 739 740 741 742 743 744 745
713
717
733
738
746 747 748 750 752 753 754 755 756 757 758 759 760 761 762 763 764 765 766 767 768 769 770 771 774 775 776 777 778 780 782 783 784 785
749 751 779 781
772
773
786 797 803
787 788 789 790 791 792 793 794 795 796 798 799 800 801 802 804 805 806 807 808 809 810 812 813 814 815 816 817 818 819 820
811
821 823 824 827 829 830 833 834 835 836 837 839 840 842 843 845 846 847 848 850 851 854 855 856 857 858 859 860
822 828
825 852
826 832 838 841 849 853
831 844 861
862 863 864 865 866 867 868 869 870 871 872 873 874 875 876 877 878 879 880 883 884 885 886 887 888 889 891 892 893 894 895 896 897
881
882
890
898 910 916
899 900 901 903 904 905 906 907 908 909 911 912 913 914 915 918 920 921 922 923 924 925 926 927 928 930 931 932 933 934 935
902 917 919
929
936 945 947 953 954 963 966
937 938 939 940 941 942 943 944 946 948 949 950 951 952 956 957 958 959 960 961 962 964 967 968 969 970
955
965
971 973 974 975 976 977 978 980 981 982 983 984 985 986 987 988 989 990 991 993 995 996 998 999 1000 1001 1002 1003 1004 1005 1008 1009 1011 1013
972 979 992 994 997 1007 1010 1012
1006
1014 1015 1016 1017 1018 1019 1020 1021 1022 1023 1024 1025 1026 1027 1028 1029 1030 1031 1032 1033 1034 1035 1036 1037 1038 1039 1040 1041 1042 1043 1044 1046 1047 1048
1045
1049
1050 1062 1069
1051 1052 1053 1054 1055 1056 1057 1059 1060 1061 1063 1064 1065 1066 1068 1070 1072 1073 1074 1075 1076 1077 1078 1079 1081 1083 1084 1085 1086 1087 1089
1058 1067 1071 1080 1082 1088
1090 1091 1092 1093 1095 1096 1098 1100 1101 1102 1103 1104 1105 1106 1107 1108 1109 1110 1112 1113 1114 1115 1116 1117 1118 1119 1121 1122 1123 1124 1125 1127 1128 1130
1094 1097 1099 1111 1120 1126
1129
1131 1144 1150
1132 1134 1135 1136 1137 1139 1140 1141 1142 1143 1145 1146 1147 1148 1149 1151 1152 1153 1154 1155 1156 1157 1158 1159 1160 1161 1162 1163 1165 1166 1167
1133 1138 1164
1168
