0
1 2 3 4 5 6 7 8 9 12 13 14 15 16 18 19 20 21 22 23 25 26 27 28 29 30 31 32 33 34 35 36
10 24
11 17
37 49
38
39 41 42 44 45 46 47 48 50 52 54 55 56 58 61 62 63 65 67 69 71 72 74 75 77 78 79 80 81
40 43 51 57 60 64 66 68 70 73 76
53
59
82 83 85 86 87 88 89 90 91 92 93 94 95 96 97 98 99 100 101 102 103 104 105 106 107 108 109 110 111 112 113 114 115 116
84
117 132 138
118
119 120 122 124 129 130 131 133 134 135 136 139 140 141 142 143 145 146 147 148 150 152 153 154 155 156 157 158 159
121
123 149 151
125
126
127
128
137
144
160 176
161 162 163 164 165 167 168 169 171 172 173 174 175 178 179 180 181 182 183 185 186 187 188 189 190 191 192 197 198 199
166 177 184
170
193
194
195
196
200 210 217
201 202 203 204 205 207 208 209 212 213 214 215 216 218 219 221 222 223 224 226 227 228 229 230 231 232 234 235 236 238 240
206 220 225 233 237 239 241
211
242 243 244 245 247 248 249 252 253 255 256 257 258 260 261 262 263 265 266 267 270 272 274 277 278 280 283 285 286 287 288
246 254 259 268 273 279 282 284
250
251
264 276
269
271
275
281
289 290 291 292 293 294 295 296 298 299 300 301 302 303 304 305 306 307 308 309 310 311 312 313 314 315 316 317 318 319 320 321 322 323
297
324 325 326 327 328 329 330 331 333 335 336 337 338 339 340 341 342 343 344 345 346 347 348 349 350 351 352 353 354 355 356 357 358
332
334
359
360 361 362 363 364 365 366 367 369 370 372 373 375 376 377 378 379 380 381 384 386 387 388 390 391 392 394 395 396 397 398 400 402
368 371 374 385 389 393 399 401
382
383
403 406 437
404 405 407 408 409 410 411 412 413 414 415 416 417 418 419 420 422 423 424 425 426 429 430 431 432 433 434 435 436 438 439 441
421
427
428
440
442 443 444 445 446 447 448 449 450 451 452 453 454 457 459 461 462 464 465 466 467 468 469 470 472 479 481 482 483 484 485 487 490 491
455
456
458 460 463 474 480 489 492
471 486
473 488
475
476
477
478
493 504 509
494 495 496 497 498 499 500 501 502 503 505 506 508 510 511 513 514 515 516 517 519 520 521 522 523 524 525 526 527
507
512 518
528 530 531 532 533 534 536 537 539 541 542 544 545 546 547 548 549 550 551 554 555 556 557 558 559 560 561 562 563
529 535 540 553
538
543
552
564 565 566 567 568 569 570 571 573 574 575 576 577 578 579 580 581 582 583 584 585 586 587 588 590 591 592 593 594 595 596 597 598
572
589
599 600 601 602 603 604 605 608 609 610 611 612 613 614 615 616 617 618 619 620 621 622 623 624 625 626 627 628 629 630 631 632 633
606
607
634 645 651
635 636 637 638 639 641 642 643 644 646 647 648 649 650 652 653 654 655 657 658 659 660 661 662 663 664 665 666 667 668
640
656
669 670 671 672 673 674 675 676 677 678 679 680 682 684 685 686 687 688 689 690 691 692 693 695 696 697 698 699 700 701 702 703
681
683
694
704
705 706 707 709 710 711 712 713 714 715 716 717 718 719 720 721 722 724 725 726 727 728 729 730 731 732 733 734 735 736 737 738
708
723
739 754 761
740 741 743 744 745 746 751 752 753 755 756 757 759 760 762 763 764 765 766 767 768 769 770 771 772 773 774 775 776 777
742
747
748
749
750
758
778 779 780 781 782 783 784 786 787 788 789 790 791 792 794 795 796 797 798 799 800 801 802 803 805 806 807 809 810 811 813 814 815
785 793 808 812
804
816 817 819 820 821 824 825 826 828 829 830 831 832 833 834 835 837 838 839 840 842 843 845 847 848 849 850 852 853 854 855 857
818 822 827 836 841 851 856
823
844
846
858 872 881
859 862 863 864 865 866 867 868 869 874 875 876 878 879 882 883 885 886 887 888 890 891 894 896 897 898 899 900 901 902
860 880
861 873 877 884 889 895
870
871
892
893
903 908 909 910 911 912 913 914 915 916 917 918 920 921 922 924 925 926 927 928 929 930 931 933 934 936 937 938 939
904 906
905 907 923
919
932
935
940 952 953 961
941 943 944 945 946 947 949 950 951 954 956 957 958 959 963 964 965 966 967 970 972 973 974 975 976 978 979 980
942 948 955 960 971 977
962
968
969
981 982 983 984 985 987 988 990 991 992 993 994 995 996 997 998 1000 1001 1002 1004 1005 1007 1010 1012 1013 1014 1015
986 989 999 1006 1009
1003
1008
1011
1016 1017 1018 1019 1020 1021 1022 1023 1024 1025 1026 1027 1028 1029 1030 1031 1032 1033 1034 1037 1038 1039 1040 1041 1042 1043 1044 1045 1046 1047 1050 1051
1035
1036
1048
1049
1052
1053 1054 1055 1056 1057 1058 1059 1060 1061 1062 1063 1064 1065 1066 1067 1068 1069 1070 1071 1072 1073 1074 1075 1076 1077 1078 1079 1080 1081 1082 1083 1085 1086
1084
1087 1088 1089 1090 1091 1092 1093 1094 1095 1096 1097 1098 1099 1100 1101 1102 1103 1104 1105 1106 1107 1108 1109 1110 1111 1112 1113 1114 1115 1116 1117 1118 1119 1121
1120
1122 1123 1124 1125 1127 1128 1129 1130 1131 1132 1134 1136 1137 1138 1139 1141 1142 1143 1145 1146 1147 1148 1149 1150 1151 1152 1154 1155 1156 1157 1158 1159 1160 1161
1126 1133 1135 1140 1144 1153
