0
1 3 4 6 7 9 10 11 12 14 15 18 20 21 24 25 26 27 28 29 30 31 32 34 35 37 38 39 40 42
2 8 13 17 23 33 36
5
16 19 22
41
43 52
44 45 46 47 48 49 51 53 54 55 56 57 58 59 60 61 62 63 64 65 66 67 68 69 70 71 72 73 74 75
50
76 77 78 79 80 81 82 83 84 85 86 87 88 89 90 91 92 93 94 95 96 97 98 99 100 101 102 103 104 105 106 107 108 109
110 111 112 113 114 115 116 117 118 119 120 121 122 123 124 125 126 127 128 129 130 131 132 133 134 135 136 137 138 139 140 141 142 143
144 145 146 147 148 149 151 152 153 155 156 157 158 159 160 161 162 163 164 166 168 169 170 171 172 173 174 175 176 177 179
150
154 178
165
167
180 181 182 183 184 185 186 187 188 189 190 191 193 194 195 196 197 198 200 201 203 205 207 208 209 210 211 212 214 215 216 217
192 202 206
199
204 213
218 233 238
219 220 222 224 225 227 228 229 231 234 235 236 237 239 240 241 242 243 244 245 246 248 249 250 251 254 256 258 259
221 223 230 232 252 255 257 260
226
247
253
261 262 263 264 265 267 269 272 274 275 277 278 279 280 281 282 283 284 286 287 289 290 292 294 295 296 297 298 300 301 302 303 304 306
266 268 273 276 288 291 293 299 305
270
271
285
307 309 310 311 312 313 314 315 318 319 320 321 322 323 324 325 326 327 328 330 331 332 333 335 336 337 338 340 342 343 344 346 347 349
308 316 329 334 339 341 345 348
317
350 361 366
351 352 353 355 357 358 359 360 362 363 364 365 367 368 369 370 371 372 373 374 375 376 378 380 382 384 385 387 389 391
354
356 377 379 381 383 386 388 390
392 393 395 396 398 399 400 401 402 403 405 407 408 410 411 412 413 414 415 416 417 418 419 421 422 424 425 426 427 429 430 432 433 434
394 397 406 409 420 423 428 431
404
435 436 437 438 439 440 441 442 443 444 445 447 448 449 450 451 452 453 454 455 456 457 458 459 460 461 462 463 464 465 466 467 468 469
446
470 471 472 473 474 475 476 477 478 479 480 481 483 484 485 486 487 488 489 490 491 492 493 494 495 496 497 498 499 500 501 502 503 504
482
505 506 508 509 510 511 512 513 514 515 517 519 520 522 523 524 525 526 527 528 529 531 534 535 537 538 539 540 541 542 543 544 545
507 516 518 530 532 536
521
533
546 557 564
547 548 549 550 551 552 553 554 555 556 558 559 561 563 565 566 567 568 569 570 571 572 573 574 575 576 577 578 579 580 581
560
562
582 583 584 585 586 587 588 589 590 591 592 593 596 597 598 599 600 601 602 603 604 605 606 609 610 611 612 613 615 616
594 607 608 614
595
617 624 626 630 635 637 641 643 645 647 650 657
618 619 620 621 622 623 625 627 628 629 631 632 633 634 636 638 640 642 644 646 648 649 651 652 653 654 655 656 658 659 660 661 662
639
663
664
665 678
666 668 669 670 671 672 673 674 675 677 679 680 681 682 683 685 686 688 689 690 691 692 693 696 699 700 702 704 705 706
667 676 687 695 701 703
684
694
697
698
707 718 724
708 709 710 711 712 713 714 715 716 717 719 720 721 722 723 726 727 728 729 730 731 733 735 736 737 738 739 740 741
725
732
734
742 746 747 749 750 751 753 754 755 756 757 758 760 761 762 763 764 766 767 768 769 773 774 775 776 777 778 779 781 782 783 784
743
744
745 748 759 772 780
752
765
770
771
785 786 787 788 789 790 791 792 793 795 796 797 798 800 801 802 803 804 805 807 808 809 810 811 812 813 814 815 816 817 818 819 820
794
799
806
821 836 844
822 823 824 825 826 829 831 832 834 838 839 840 841 843 845 847 849 850 851 853 854 855 856 857 858 859 860 861 862 863
827
828 830 833 837 842 846 848 852
835
864 865 866 867 868 869 870 871 872 873 874 875 876 877 878 879 880 881 882 883 884 885 887 888 889 890 891 892 893 894 895 896 897 898
886
899 915 918 922 923
900 916 919
901 902 903 905 908 909 910 911 912 913 917 920 921 924 926 927 929 931 933 934 935 936 937 938 941 942 943 944
904
906
907 914 925 928
930
932
939
940
945 956 962
946 947 948 949 950 951 952 953 954 955 957 958 959 961 963 964 966 967 968 969 970 971 972 973 975 976 977 978
960
965
974
979 980 981 982 983 984 985 986 987 988 989 990 991 992 993 994 995 996 997 999 1000 1002 1004 1005 1006 1007 1009 1011 1012 1013 1014 1016 1017
998 1003 1010
1001 1015
1008
1018 1019 1020 1021 1022 1023 1024 1025 1026 1028 1029 1030 1031 1032 1033 1034 1035 1036 1037 1039 1040 1041 1042 1043 1044 1045 1046 1047 1048 1049 1050 1051 1052
1027
1038
1053 1054 1055 1056 1057 1058 1059 1060 1061 1062 1063 1064 1066 1068 1069 1070 1074 1075 1078 1080 1082 1083 1084 1085 1086 1087 1088 1090 1093
1065 1067 1071 1081 1091
1072
1073 1076 1079 1089 1092
1077
1094 1095 1096 1098 1099 1100 1101 1103 1105 1106 1107 1108 1109 1110 1111 1112 1113 1114 1115 1116 1117 1118 1120 1121 1122 1123 1124 1125 1126 1127 1128 1129 1130 1132
1097 1102 1104 1119 1131 1133
1134 1137 1143 1152 1156 1160 1164
1135 1136 1138 1139 1140 1141 1142 1144 1145 1147 1148 1149 1150 1151 1153 1154 1155 1157 1158 1159 1161 1162 1163 1165 1166 1167 1168 1169 1170 1171 1172 1173 1174
1146
